************************************************************************
*  PROGRAMA.... RNSHELLOWORD                                           *
*  OBJETIVO.... hello-word                                             *
*  AUTOR....... RNS                                                    *
*  DATA........ 04/2016                                                *
************************************************************************
WRITE 'Hello, World!'
END